NO ./textures/no_wall.png
SO ./textures/so_wall.png
WE ./textures/we_wall.png
EA ./textures/ea_wall.png

C 255, 255, 255
F 255, 255, 0

        11111111111111111111111
        10000000010000000000001
        10110000010000000000001
        10010000000000000000001
1111111110110000010000000000001
1000000000110000010111111111111
111101111111110110000010001
111101111111110111010010001
110000001101010110000010001
10000S000000000010000010001
100000000010000011010011111
11001001110101011101111111111
11110111111010111111011111
11111111 1111111 111111111
